111111111111
100000001001
110101101111
100111100001
101010110121
101001011111
100001010001
101000100101
101101001301
100000010111
100000100001
111111111111
