11111111111111111111
10000111110001110001
10110000000100000101
10111111111111111101
10001111111111110001
10100111111111110111
10110001111113010001
10001100000010001101
10101010000000010001
10111001111111111011
11000100000010000001
10010001111110111001
12110010001000111001
10001010101011000001
10001100101001110001
10110000100001110001
10100010101000000101
10001111111111011101
10000000000000000001
11111111111111111111
