11111111111111111111
10210000010010000001
10000111010110111101
10111110010000110101
10001311000101110001
10001001111111111101
10001100000111010001
10011110110010000101
11010000000110110111
10010111011111110001
11010000000010011001
10010000111010001101
10111110001001010001
10000010001000000111
11101110001110111111
10001010100010000001
10101001100011111001
10111010000100100001
10001000110110001001
11111111111111111111
