11111111111111111111
13010100101110000001
10000000000001110111
10111111101101000001
10111011000100011011
10111101111111110001
10111101000010010101
10000000111010100101
10111100000010001001
10001111111111111111
10010100110010000001
10110010111110000001
10010001101000110001
11000000101001100001
10010000001201001001
10010000101110011001
10111111100000100001
10011000001111001001
10000100100000000001
11111111111111111111
